*********
*0003000*
*1***0*T*
*00*000**
*0***0***
*0400000*
*0*0**02*
*000*00**
***E*****